{
    "name": "level_1",
    "width" : 10,
    "tileset": "level1.ts.json",
    "tiles": [
        0, 0, 0, 0, 0, 0, 0, 0, 0, 0,
        0, 0, 0, 0, 0, 0, 0, 0, 0, 0,
        0, 0, 0, 0, 0, 0, 0, 0, 0, 0,
        0, 0, 0, 0, 0, 0, 0, 0, 0, 0,
        0, 0, 0, 0, 0, 0, 0, 0, 0, 0,
        0, 0, 0, 0, 0, 0, 0, 0, 0, 0,
        0, 12,13, 0, 0, 0, 0, 0, 0, 0,
        0, 2, 3, 0, 0, 0, 0, 0, 0, 0,
        0, 28,29, 0, 0, 0, 0, 0, 0, 0,
        54, 55, 55, 55, 55, 55, 55, 55, 55, 58
    ]
}