{
    "name": "test",
    "width" : 10,
    "tileset": "level1.ts.json",
    "tiles": [
        0, 0, 0, 0, 0, 0, 0, 0, 0, 0,
        0, 0, 0, 0, 0, 0, 0, 0, 0, 0,
        0, 0, 0, 0, 0, 0, 0, 0, 0, 0,
        0, 0, 0, 0, 0, 0, 0, 0, 0, 0,
        0, 0, 0, 0, 0, 0, 0, 0, 0, 0,
        0, 0, 0, 0, 0, 0, 0, 0, 0, 0,
        4, 0, 4, 0, 4, 0, 4, 0, 4, 0,
        5, 0, 5, 0, 5, 0, 5, 0, 5, 0,
        6, 0, 6, 0, 6, 0, 6, 0, 6, 0,
        1, 2, 2, 2, 2, 2, 2, 2, 2, 3
    ]
}